START: 1, 1
END: 8, 8
LAYOUT:
1 1 1 1 1 1 1 1 1 1
1 0 0 0 0 0 0 0 0 1
1 0 1 1 1 1 1 1 1 1
1 0 1 0 0 0 0 0 0 1
1 0 1 0 1 1 1 1 1 1
1 0 1 0 1 0 0 0 0 1
1 0 1 0 1 0 1 1 1 1
1 0 1 0 1 0 1 1 1 1
1 0 0 0 0 0 0 0 0 1
1 1 1 1 1 1 1 1 1 1